############
#...#......#
#.#.#.####.#
###.#....#.#
#....###.#.#
####.#F#.#.#
#..#.#.#.#.#
##.#.#.#.#.#
#........#.#
######.###.#
#......#...#
########.###